A	"A:
ABSOLUT	a p s U "l }: t
ACCEPTERA	a k s e p "t e: r a
ADAM	"A: d a m
ADJÖ	a "j 9
ADRESS	a "d r E s
ADVOKAT	a d v U "k A: t
AFFÄR	a "f E: r
AFFÄREN	a "f E: r e n
AFFÄRER	a "f E: r e r
AGENT	a "g E n t
AJ	"a j
AKTA	"a k t a
AL	"A: l
ALAN	a "l A: n
ALDRIG	"a l d r I g
ALEX	"a l e k s
ALICE	"a l I s
ALL	"a l
ALLA	"a l a
ALLDELES	"a l d e l e s
ALLIHOP	a l I "h u: p
ALLIHOPA	a l I "h u: p a
ALLS	"a l s
ALLT	"a l t
ALLTID	"a l t I d
ALLTIHOP	a l t I "h u: p
ALLTING	"a l t I N
ALLTSÅ	"a l t s O
ALLVAR	"a l v A: r
ALLVARLIGT	"a l %v A: l` I k t
AMATÖRAKTIG	a m a "t 2: r %a k t I g
AMERIKA	a "m e: r I k a
AMERIKANSKA	a m e r I "k A: n s k a
AN	"a n
AND	"a n d
ANDAS	"a n d a s
ANDRA	"a n d r A:
ANDY	"a n d Y
ANING	"A: n I N
ANLEDNING	"a n %l e: d n I N
ANNA	"a n a
ANNAN	"a n a n
ANNANSTANS	"a n a n %s t a n s
ANNARS	"a n a s`
ANNAT	"a n a t
ANNORLUNDA	"a n U %l` u0 n d a 
ANSER	"a n %s e: r
ANSIKTE	"a n s I k t e
ANSIKTET	"a n s I k t e t
ANSVAR	"a n %s v A: r
ANSVARIG	"a n %s v A: r I g
ANTAGLIGEN	"a n %t A: g l I g e n
ANTAR	"a n %t A: r
ANTINGEN	"a n t I N e n
ANVÄND	"a n %v E n d
ANVÄNDA	"a n %v E n d a
ANVÄNDE	"a n %v E n d e
ANVÄNDER	"a n %v E n d e r
AR	"A: r
ARBETA	"a r b e: t a
ARBETAR	"a r b e: t a r
ARBETE	"a r b e: t e
ARBETET	"a r b e: t e t
ARG	"a r j
ARM	"a r m
ARMÉ	a r "m e:
ARMÉN	a r "m e: n
ARTHUR	"a t` u0 r
ATT	"a t
AV	a v
AVSKYR	"A: v %S y: r
AVSLUTA	"A: v %s l }: t a
AVTAL	"A: v %t A: l
B	"b e:
BABY	"b E: b I
BACKA	"b a k a
BAD	"b A: d
BAK	"b A: k
BAKOM	"b A: k O m
BAND	"b a n d
BANDET	"b a n d e t
BANKEN	"b a N k e n
BAR	"b A: r
BARA	"b A: r a
BAREN	"b A: r e n
BARN	"b A: n`
BARNEN	"b A: n` e n
BARNET	"b A: n` e t
BE	"b e:
BEGÄR	b e "j E: r
BEHÅLLA	b e "h O l a
BEHÖVA	b e "h 2: v a
BEHÖVDE	b e "h 2: v d e
BEHÖVER	b e "h 2: v e r
BEHÖVS	b e "h 2: f s
BEKLAGAR	b e "k l A: g a r
BEN	"b e: n
BENEN	"b e: n e n
BER	"b e: r
BEREDD	b e "r E d
BEROR	b e "r u: r
BERÄTTA	b e "r E t a
BERÄTTADE	b e "r E t a d e
BERÄTTAR	b e "r E t a r
BERÄTTAT	b e "r E t a t
BESLUT	b e "s l }: t
BESTÄMMA	b e "s t E m a
BESTÄMMER	b e "s t E m e r
BESTÄMT	b e "s t E m t
BESVIKEN	b e "s v i: k e n
BESÖK	b e "s 2: k
BETALA	b e "t A: l a
BETALADE	b e "t A: l a d e
BETALAR	b e "t A: l a r
BETALT	b e "t A: l t
BETT	"b E t
BETYDER	b e "t y: d e r
BEVIS	b e "v i: s
BEVISA	b e "v i: s a
BIG	"b I g
BIL	"b i: l
BILAR	"b i: l a r
BILD	"b I l d
BILDEN	"b I l d e n
BILDER	"b I l d e r
BILEN	"b i: l e n
BILL	"b I l
BILLY	"b I l Y
BIT	"b i: t
BJUDA	"b j }: d a
BJUDER	"b j }: d e r
BJÖD	"b j 2: d
BLAND	"b l a n d
BLEV	"b l e: v
BLI	"b l i:
BLIR	"b l i: r
BLIVIT	"b l i: v I t
BLOD	"b l u: d
BLODET	"b l u: d e t
BLOMMOR	"b l U m U r
BLÅ	"b l o:
BO	"b u:
BOB	"b O b
BODDE	"b U d e
BOK	"b u: k
BOKEN	"b u: k e n
BOLLEN	"b O l e n
BOR	"b u: r
BORD	"b u: d`
BORDE	"b u: d` e
BORDET	"b u: d` e t
BORT	"b O t`
BORTA	"b O t` a
BRA	"b r a
BREDVID	"b r e: %d v i: d
BREV	"b r e: v
BRIAN	"b r a j a n
BRODER	"b r u: d e r
BROR	"b r u: r
BROTT	"b r O t
BRUKADE	"b r }: k a d e
BRUKAR	"b r }: k a r
BRY	"b r y:
BRYR	"b r y: r
BRYTA	"b r y: t a
BRYTER	"b r y: t e r
BRÅTTOM	"b r O t O m
BRÖDER	"b r 2: d e r
BRÖLLOP	"b r 9 l O p
BRÖST	"b r 9 s t
BRÖT	"b r 2: t
BUSSEN	"b u0 s e n
BYGGA	"b Y g a
BYGGER	"b Y g e r
BYGGNADEN	"b Y g n a d e n
BYTA	"b y: t a
BÄR	"b E: r
BÄRA	"b E: r a
BÄST	"b E s t
BÄSTA	"b E s t a
BÄTTRE	"b E t r e
BÅDA	"b o: d a
BÅDE	"b o: d e
BÅT	"b o: t
BÅTEN	"b o: t e n
BÖCKER	"b 9 k e r
BÖG	"b 2: g
BÖR	"b 2: r
BÖRJA	"b 9 r j a
BÖRJADE	"b 9 r j a d e
BÖRJAN	"b 9 r j a n
BÖRJAR	"b 9 r j a r
BÖRJAT	"b 9 r j a t
CARL	"k A: l`
CARTER	"k A: t` e r
CHANS	"s' a N s
CHANSEN	"s' a N s e n
CHARLES	"s' A: l` s`
CHARLIE	"s' A: l` I
CHEF	"S e: f
CHEFEN	"S e: f e n
CHRIS	"k r I s
CHUCK	"S u0 k
CITY	"s I t Y
CLAIRE	"k l E: r
CLARK	"k l A: r k
COLLEGE	"k O l I t s'
COOLT	"k u: l t
D	"d e:
DA	"d A:
DAG	"d A: g
DAGAR	"d A: g a r
DAGARNA	"d A: g a n` a
DAGEN	"d A: g e n
DAGENS	"d A: g e n s
DAGS	"d A: g s
DAM	"d A: m
DAMEN	"d A: m e n
DAMER	"d A: m e r
DAN	"d A: n
DANIEL	"d A: n I e l
DANNY	"d a n I
DANSA	"d a n s a
DANSAR	"d a n s a r
DAR	"d A: r
DATOR	"d A: t U r
DAVE	"d E j v
DAVID	"d A: v I d
DE	"d E
DEFINITIVT	d e f I n I "t i: f t
DEJ	"d E j
DEL	"d e: l
DELA	"d e: l a
DELAR	"d e: l a r
DELEN	"d e: l e n
DEM	"d O m
DEN	d e n
DENNA	"d E n a
DERAS	"d e: r a s
DESS	"d E s
DESSA	"d E s a
DESSUTOM	d e "s }: t O m
DESTO	"d E s t U
DET	"d e: t
DETSAMMA	d e t "s a m a
DETTA	"d e t a
DIG	"d E j
DIN	"d I n
DINA	"d i: n a
DIREKT	d I "r E k t
DISKUTERA	d I s k }: "t e: r a
DIT	"d i: t
DITT	"d I t
DJUPT	"j }: p t
DJUR	"j }: r
DOG	"d u: g
DOKTOR	"d O k t O r
DOKTORN	"d O k t O n`
DOLLAR	"d O l a r
DOM	"d o: m
DON	"d u: n
DOTTER	"d O t e r
DR	"d O k t O r
DRA	"d r A:
DRACK	"d r a k
DRAR	"d r A: r
DRICK	"d r I k
DRICKA	"d r I k a
DRICKER	"d r I k e r
DRINK	"d r I N k
DRIVER	"d r i: v e r
DROG	"d r u: g
DROGER	"d r o: g e r
DROTTNING	"d r O t n I N
DRÖM	"d r 9 m
DRÖMMAR	"d r 9 m a r
DU	"d }:
DUGER	"d }: g e r
DUKTIG	"d u0 k t I g
DUM	"d u0 m
DUMMA	"d u0 m a
DUMT	"d u0 m t
DYKER	"d y: k e r
DÄR	d E r
DÄRFÖR	"d E: r f 9 r
DÄRIFRÅN	"d E: r I f r o: n
DÅ	"d o:
DÅLIG	"d o: l I g
DÅLIGA	"d o: l I g a
DÅLIGT	"d o: l I k t
DÖ	"d 2:
DÖD	"d 2: d
DÖDA	"d 2: d a
DÖDAD	"d 2: d a d
DÖDADE	"d 2: d a d e
DÖDAR	"d 2: d a r
DÖDAT	"d 2: d a t
DÖDEN	"d 2: d e n
DÖK	"d 2: k
DÖR	"d 2: r
DÖRR	"d 9 r
DÖRREN	"d 9 r e n
DÖTT	"d 9 t
E	"e:
ED	"e: d
EDDIE	"E d I
EFTER	"E f t e r
EFTERMIDDAG	"E f t e r %m I d A: g
EFTERSOM	e f t e "s` O m
EFTERÅT	"E f t e r %o: t
EGEN	"e: g e n
EGENTLIGEN	e "j E n t l I g e n
EGET	"e: g e t
EGNA	"e: g n a
EJ	"E j
ELD	"E l d
ELLER	"E l e r
EMILY	"E m I l Y
EMMA	"E m a
EMOT	e m U t
EN	"e: n
ENA	"e: n a
ENDA	"E n d a
ENDAST	"E n d a s t
ENERGI	e n e r "S i:
ENGELSKA	"E N e l s k a
ENGLAND	"E N l a n d
ENKELT	"E N k e l t
ENLIGT	"e: n l I k t
ENS	"e: n s
ENSAM	"E n %s a m
ENSAMMA	"E n %s a m a
ER	"e: r
ERA	"e: r a
ERIC	"e: r I k
ERKÄNNA	"e: r %s' E n a
ERS	"e: s`
ERT	"e: t`
ETT	"E t
EVIGT	"e: v I k t
EXAKT	e k "s a k t
EXEMPEL	e k "s E m p e l
EXTRA	"E k s t r a
FADER	"f A: d e r
FAKTISKT	"f a k t I s k t
FAKTUM	"f a k t u0 m
FALL	"f a l
FALLER	"f a l e r
FALLET	"f a l e t
FAMILJ	f a "m I l j
FAMILJEN	f a "m I l j e n
FAN	"f A: n
FANN	"f a n
FANNS	"f a n s
FANTASTISK	f a n "t a s t I s k
FANTASTISKT	f a n "t a s t I s k t
FAR	"f A: r
FARA	"f A: r a
FARBROR	"f a r %b r U r
FARFAR	"f a r %f a r
FARLIG	"f A: l` I g
FARLIGT	"f A: l` I k t
FARMOR	"f a r %m U r
FARS	"f a s`
FART	"f A: t`
FARVÄL	f A: r "v E: l
FAST	"f a s t
FATTA	"f a t a
FATTAR	"f a t a r
FBI	e f b e: "i:
FEL	"f e: l
FEM	"f E m
FEST	"f E s t
FESTEN	"f E s t e n
FICK	"f I k
FIENDEN	"f i: e n d e n
FIENDER	"f i: e n d e r
FILM	"f I l m
FILMEN	"f I l m e n
FIN	"f i: n
FINA	"f i: n a
FINNAS	"f I n a s
FINNS	"f I n s
FINT	"f I n t
FIRA	"f i: r a
FISK	"f I s k
FIXA	"f I k s a
FIXAR	"f I k s a r
FLER	"f l e: r
FLERA	"f l e: r a
FLESTA	"f l E s t a
FLICKA	"f l I k a
FLICKAN	"f l I k a n
FLICKOR	"f l I k U r
FLICKORNA	"f l I k U n` a
FLICKVÄN	"f l I k %v E n
FLODEN	"f l u: d e n
FLY	"f l y:
FLYGA	"f l y: g a
FLYGER	"f l y: g e r
FLYTTA	"f l Y t a
FLYTTADE	"f l Y t a d e
FLYTTAR	"f l Y t a r
FLÖG	"f l 2: g
FOLK	"f O l k
FOLKET	"f O l k e t
FORM	"f O r m
FORT	"f O t`
FORTARE	"f U t` a r e
FORTFARANDE	"f U t` %f A: r a n d e
FORTSÄTT	"f U t` s` E t
FORTSÄTTA	"f U t` %s` E t a
FORTSÄTTER	"f U t` %s` E t e r
FOT	"f u: t
FRAM	"f r a m
FRAMFÖR	"f r a m %f 2: r
FRAMME	"f r a m e
FRAMTID	"f r a m %t i: d
FRAMTIDEN	"f r a m %t i: d e n
FRAMÅT	"f r a m o: t
FRANK	"f r a N k
FRANKRIKE	"f r a N k r I k e
FRANSKA	"f r a n s k a
FRED	"f r e: d
FREDAG	"f r e: d A: g
FRI	"f r i:
FRIA	"f r i: a
FRIHET	"f r i: %h e: t
FRISK	"f r I s k
FRU	"f r }:
FRUKOST	"f r u0 k O s t
FRUN	"f r }: n
FRÅGA	"f r o: g a
FRÅGADE	"f r o: g a d e
FRÅGAN	"f r o: g a n
FRÅGAR	"f r o: g a r
FRÅGOR	"f r o: g U r
FRÅN	"f r o: n
FRÖKEN	"f r 2: k e n
FULL	"f u0 l
FULLA	"f u0 l a
FULLT	"f u0 l t
FUNDERA	f u0 n "d e: r a
FUNGERA	f u0 N "g e: r a
FUNGERAR	f u0 N "g e: r a r
FUNKAR	"f u0 N k a r
FYRA	"f y: r a
FÄLLA	"f E l a
FÄNGELSE	"f E N e l s e
FÄNGELSET	"f E N e l s e t
FÄRDIG	"f E: d` I g
FÄRG	"f E r j
FÅ	%f o:
FÅNGA	"f O N a
FÅNGAR	"f O N a r
FÅR	"f o: r
FÅTT	"f O t
FÖDD	"f 9 d
FÖDDES	"f 9 d e s
FÖDELSEDAG	"f 2: d e l s e %d A: g
FÖLJ	"f 9 l j
FÖLJA	"f 9 l j a
FÖLJDE	"f 9 l j d e
FÖLJER	"f 9 l j e r
FÖLL	"f 9 l
FÖNSTRET	"f 9 n s t r e t
FÖR	"f 2: r
FÖRA	"f 2: r a
FÖRBANNADE	f 9 r "b a n a d e
FÖRBI	f 9 r "b i:
FÖRE	"f 2: r e
FÖREDRAR	"f 2: r e %d r A: r
FÖRESLÅR	"f 2: r e %s l o: r
FÖRESTÄLLA	"f 2: r e %s t E l a
FÖRETAG	"f 2: r e %t A: g
FÖRFLUTNA	f 9 r "f l }: t n a
FÖRHÅLLANDE	f 9 r "h O l a n d d e
FÖRKLARA	f 9 r "k l A: r a
FÖRKLARAR	f 9 r "k l A: r a r
FÖRLORA	f 9 "l` u: r a
FÖRLORADE	f 9 "l` u: r a d e
FÖRLORAR	f 9 "l` u: r a r
FÖRLORAT	f 9 "l` u: r a t
FÖRLÅT	"f 9 %l` o: t
FÖRLÅTA	f 9 "l` o: t a
FÖRMODLIGEN	f 9 r "m u: d l I g e n
FÖRR	"f 9 r
FÖRRA	"f 9 r a
FÖRRESTEN	f 9 "r E s t e n
FÖRRÄN	"f 9 r E n
FÖRSIKTIG	f 9 "s` I k t I g
FÖRSIKTIGT	f 9 "s` I k t I k t
FÖRSLAG	f 9 "s` l` A: g
FÖRST	"f 9 s` t`
FÖRSTA	"f 9 s` t` a
FÖRSTOD	f 9 "s` t` u: d
FÖRSTÅ	f 9 "s` t` o:
FÖRSTÅR	f 9 "s` t` o: r
FÖRSTÅS	f 9 "s` t` o: s
FÖRSTÅTT	f 9 "s` t` O t
FÖRSTÖR	f 9 "s` t` 2: r
FÖRSTÖRA	f 9 "s` t` 2: r a
FÖRSTÖRDE	f 9 "s` t` 2: d` e
FÖRSVANN	f 9 "s` v a n
FÖRSVARA	f 9 "s` v A: r a
FÖRSVINN	f 9 "s` v I n
FÖRSVINNA	f 9 "s` v I n a
FÖRSVINNER	f 9 "s` v I n e r
FÖRSÖK	f 9 "s` 2: k
FÖRSÖKA	f 9 "s` 2: k a
FÖRSÖKER	f 9 "s` 2: k e r
FÖRSÖKT	f 9 "s` 2: k t
FÖRSÖKTE	f 9 "s` 2: k t e
FÖRTJÄNAR	f 9 r "s' E: n a r
FÖRUT	f 2: r "}: t
FÖRUTOM	f 9 r "}: t O m
FÖRVÄNTAR	f 9 r "v E n t a r
FÖRVÅNAD	f 9 r "v o: n a d
FÖRÄLDRAR	f 9 r "E l d r a r
FÖRÄNDRAS	f 9 r "E n d r a s
FÖRÄNDRATS	f 9 r "E n d r a t s
FÖTTER	"f 9 t e r
GALEN	"g A: l e n
GALET	"g A: l e t
GALNA	"g A: l n a
GAMLA	"g a m l a
GAMLE	"g a m l e
GAMMAL	"g a m a l
GANSKA	"g a n s k a
GATAN	"g A: t a n
GAV	"g A: v
GE	"j e:
GENAST	"j e: n a s
GENERAL	j e n e "r A: l
GENOM	j e "n o: m
GEORGE	"j e: O r j
GER	"j e: r
GETT	"j E t
GICK	"j I k
GIFT	"j I f t
GIFTA	"j I f t a
GIFTE	"j I f t e
GIFTER	"j I f t e r
GILLA	"j I l a
GILLADE	"j I l a d e
GILLAR	"j I l a r
GISSA	"j I s a
GIVETVIS	"j i: v e %t v i: s
GJORDE	"j u: d` e
GJORT	"j U t`
GLAD	"g l A: d
GLADA	"g l A: d a
GLAS	"g l A: s
GLÖM	"g l 9 m
GLÖMDE	"g l 9 m d e
GLÖMMA	"g l 9 m a
GLÖMMER	"g l 9 m e r
GLÖMT	"g l 9 m t
GOD	"g u: d
GODA	"g u: d a
GODE	"g u: d e
GOLVET	"g O l v e t
GOTT	"g O t
GRABB	"g r a b
GRABBAR	"g r a b a r
GRABBEN	"g r a b e n
GRATIS	"g r A: t I s
GRATTIS	"g r a t I s
GRAVID	g r a "v i: d
GREJ	"g r E j
GREJEN	"g r E j e n
GREJER	"g r E j e r
GRUND	"g r u0 n d
GRUPP	"g r u0 p
GRÄNSEN	"g r E n s e n
GRÅTA	"g r o: t a
GRÅTER	"g r o: t e r
GUD	"g }: d
GUDS	"g }: d s
GULD	"g u0 l d
GUMMAN	"g u0 m a n
GÄLLER	"j E l e r
GÄNG	"j E N
GÄRNA	"j E: n` a
GÅ	"g o:
GÅNG	"g O N
GÅNGEN	"g O N e n
GÅNGER	"g O N e r
GÅR	"g o: r
GÅTT	"g O t
GÅVA	"g o: v a
GÖMMA	"j 9 m a
GÖMMER	"j 9 m e r
GÖR	"j 2: r
GÖRA	"j 2: r a
HA	"h A:
HADE	"h a d e
HAFT	"h a f t
HALLÅ	h a "l o:
HALSEN	"h a l s e n
HALV	"h a l v
HALVA	"h a l v a
HAMNA	"h a m n a
HAMNADE	"h a m n a d e
HAMNAR	"h a m n a r
HAN	"h a n
HAND	"h a n d
HANDEN	"h a n d e n
HANDLAR	"h a n d l a r
HANS	"h a n s
HANTERA	h a n "t e: r a
HAR	"h A: r
HARRY	"h a r Y
HATAR	"h A: t a r
HAVET	"h A: v e t
HEJ	"h E j
HEJDÅ	"h E j d o:
HEJSAN	"h E j s a n
HEL	"h e: l
HELA	"h e: l a
HELGEN	"h E l j e n
HELIGA	"h e: l I g a
HELLER	"h E l e r
HELLRE	"h E l r e
HELST	"h E l s t
HELT	"h e: l t
HELVETE	"h E l v e t e
HELVETET	"h E l v e t e t
HEM	"h E m
HEMLIGA	"h E m l I g a
HEMLIGHET	"h E m l I g %h e: t
HEMLIGHETER	"h E m l I g %h e: t e r
HEMMA	"h E m a
HEMSK	"h E m s k
HEMSKA	"h E m s k a
HEMSKT	"h E m s k t
HENNE	"h E n e
HENNES	"h E n e s
HENRY	"h E n r Y
HERR	"h E r
HERRAR	"h E r a r
HERRE	"h E r e
HERREGUD	h E r e "g }: d
HERRN	"h E n`
HETER	"h e: t e r
HETTE	"h E t e
HIMLEN	"h I m l e n
HINDRA	"h I n d r a
HINNER	"h I n e r
HISTORIA	h I "s t u: r I a
HISTORIEN	h I "s t u: r I e n
HIT	"h I t
HITTA	"h I t a
HITTADE	"h I t a d e
HITTAR	"h I t a r
HITTAT	"h I t a t
HJÄLP	"j E l p
HJÄLPA	"j E l p a
HJÄLPER	"j E l p e r
HJÄLPTE	"j E l p t e
HJÄLTE	"j E l t e
HJÄRNA	"j E: n` a
HJÄRNAN	"j E: n` a n
HJÄRTA	"j E t` a
HJÄRTAT	"j E t` a t
HON	"h U n
HONOM	"h O n O m
HOPP	"h O p
HOPPA	"h O p a
HOPPADE	"h O p a d e
HOPPADES	"h O p a d e s
HOPPAR	"h O p a r
HOPPAS	"h O p a s
HORA	"h u: r a
HOS	"h U s
HOT	"h u: t
HOTELL	h U "t E l
HOTELLET	h U "t E l e t
HUND	"h u0 n d
HUNDAR	"h u0 n d a r
HUNDEN	"h u0 n d e n
HUNDRA	"h u0 n d r a
HUNGRIG	"h u0 N r I g
HUR	"h }: r
HUS	"h }: s
HUSET	"h }: s e t
HUSTRU	"h u0 s t r }:
HUVUD	"h }: v u0 d
HUVUDET	"h }: v u0 d e t
HÄFTIGT	"h E f t I k t
HÄLFTEN	"h E l f t e n
HÄLSA	"h E l s a
HÄMTA	"h E m t a
HÄMTAR	"h E m t a r
HÄNDA	"h E n d a
HÄNDE	"h E n d e
HÄNDER	"h E n d e r
HÄNDERNA	"h E n d e n` a
HÄNGA	"h E N a
HÄNGER	"h E N e r
HÄNT	"h E n t
HÄR	"h E: r
HÄRIFRÅN	"h E: r I f r o: n
HÄRLIGT	"h E: l` I k t
HÄST	"h E s t
HÅL	"h o: l
HÅLL	"h O l
HÅLLA	"h O l a
HÅLLER	"h O l e r
HÅLLET	"h O l e t
HÅLLIT	"h O l I t
HÅR	"h o: r
HÅRD	"h o: d`
HÅRET	"h o: r e t
HÅRT	"h o: t`
HÖG	"h 2: g
HÖGER	"h 2: g e r
HÖGRE	"h 2: g %r e
HÖGSTA	"h 9 k s t a
HÖGT	"h 9 k t
HÖLL	"h 9 l
HÖR	"h 2: r
HÖRA	"h 2: r a
HÖRDE	"h 2: d` e
HÖRT	"h 2: t`
I	%I
IBLAND	"i: b l a n d d
IDAG	I "d A: g
IDIOT	I d I "u: t
IDIOTER	I d I "u: t e r
IDÉ	I "d e:
IDÉER	I "d e: e r
IFALL	I "f a l
IFRED	I "f r e: d
IFRÅN	I "f r o: n
IGEN	I "j E n
IGENOM	I "j e: n O m
IGÅNG	I "g O N
IGÅR	I "g o: r
IHJÄL	I "j E: l
IHOP	I "h u: p
IHÅG	I "h o: g
IKVÄLL	I "k v E l
ILLA	"I l a
IMORGON	I "m O r g O n
IN	"I n
INBLANDAD	"I n %b l a n d d a d
INFORMATION	I n f O r m a "S u: n
INFÖR	"I n %f 2: r
INGA	"I N a
INGEN	"I N e n
INGENSTANS	"I N e n s t a n s
INGENTING	I N e n "t I N
INGET	"I N e t
INNAN	"I n a n
INNE	"I n e
INNEBÄR	"I n e %b E: r
INOM	"I n %O m
INSER	"I n %s e: r
INSÅG	"I n %s o: g
INTE	"I n t e
INTRESSANT	I n t r e "s a n t
INTRESSERAD	I n t r e "s e: r a d
IS	"i: s
ISTÄLLET	I "s t E l e t
IVÄG	i: "v E: g
JA	"j A:
JACK	"j a k
JAG	"j A: g
JAGA	"j A: g a
JAGAR	"j A: g a r
JAHA	j A: "h A:
JAMES	"j E j m s
JANE	"j E j n
JAPP	"j a p
JASON	"j A: s O n
JASÅ	"j a s O
JAVISST	j a "v I s t
JERRY	"j E r Y
JESUS	"j e: s u0 s
JIM	"j I m
JIMMY	"j I m Y
JO	"j u:
JOBB	"j O b
JOBBA	"j O b a
JOBBADE	"j O b a d e
JOBBAR	"j O b a r
JOBBAT	"j O b a t
JOBBET	"j O b e t
JOBBIGT	"j O b I k t
JOE	"j u:
JOHN	"j O n
JOHNNY	"j O n Y
JORDEN	"j u: d` e n
JU	"j u0
JUL	"j }: l
JUST	"S Y s t
JÄKLA	"j E: k l a
JÄMT	"j E m t
JÄTTEBRA	"j E t e %b r A:
JÄVEL	"j E: v e l
JÄVELN	"j E: v e l n
JÄVLA	"j E: v l a
JÄVLAR	"j E: v l a r
JÄVLIGT	"j E: v l I k t
KAFFE	"k a f e
KALLA	"k a l a
KALLADE	"k a l a d e
KALLAR	"k a l a r
KALLAS	"k a l a s
KALLT	"k a l t
KAMERAN	"k A: m e r a n
KAN	"k a n
KANSKE	"k a n` s` e
KAPTEN	k a p "t e: n
KARL	"k A: r
KARRIÄR	k a r I "E: r
KASTA	"k a s t a
KASTADE	"k a s t a d e
KASTAR	"k a s t a r
KATT	"k a t
KEVIN	"k E v I n
KILLAR	"k I l a r
KILLARNA	"k I l a n` a
KILLE	"k I l e
KILLEN	"k I l e n
KILOMETER	s' i: l U "m e: t e r
KLAR	"k l A: r
KLARA	"k l A: r a
KLARADE	"k l A: r a d e
KLARAR	"k l A: r a r
KLART	"k l A: t`
KLASS	"k l a s
KLOCKAN	"k l O k a n
KLUBBEN	"k l u0 b e n
KLÄ	"k l E:
KLÄDER	"k l E: d e r
KLÄDERNA	"k l E: d e n` a
KM	s' i: l U "m e: t e r
KNAPPAST	"k n a p a s t
KNAPPT	"k n a p t
KNULLA	"k n u0 l a
KOLL	"k O l
KOLLA	"k O l a
KOLLADE	"k O l a d e
KOLLAR	"k O l a r
KOM	"k O m
KOMMA	"k O m a
KOMMER	"k O m e r
KOMMIT	"k O m I t
KOMPIS	"k O m p I s
KOMPISAR	"k O m p I s a r
KONSTIG	"k O n s t I g
KONSTIGT	"k O n s t I k t
KONTAKT	k O n "t a k t
KONTAKTA	k O n "t a k t a
KONTOR	k O n "t u: r
KONTORET	k O n "t u: r e t
KONTROLL	k O n "t r O l
KONTROLLERA	k O n t r U "l e: r a
KOPP	"k O p
KOPPLA	"k O p l a
KORT	"k U t`
KOSTAR	"k O s t a r
KRAFT	"k r a f t
KRAFTER	"k r a f t e r
KRIG	"k r i: g
KRIGET	"k r i: g e t
KROPP	"k r O p
KROPPEN	"k r O p e n
KRÄVER	"k r E: v e r
KRÄVS	"k r E v s
KUK	"k }: k
KUL	"k }: l
KUNDE	"k u0 n d e
KUNG	"k u0 N
KUNGEN	"k u0 N e n
KUNNA	"k u0 n a
KUNNAT	"k u0 n a t
KUSIN	k }: "s i: n
KVAR	"k v A: r
KVINNA	"k v I n a
KVINNAN	"k v I n a n
KVINNOR	"k v I n U r
KVÄLL	"k v E l
KVÄLLEN	"k v E l e n
KYRKAN	"s' Y r k a n
KYSS	"s' Y s
KÄFT	"s' E f t
KÄFTEN	"s' E f t e n
KÄMPA	"s' E m p a
KÄND	"s' E n d
KÄNDE	"s' E n d e
KÄNDES	"s' E n d e s
KÄNNA	"s' E n a
KÄNNER	"s' E n e r
KÄNNS	"s' E n s
KÄNSLA	"s' E n s l a
KÄNSLOR	"s' E n s l U r
KÄNT	"s' E n t
KÄR	"s' E: r
KÄRA	"s' E: r a
KÄRLEK	"s' E: %l` e: k
KÄRLEKEN	"s' E: %l` e: k e n
KÖKET	"s' 2: k e t
KÖPA	"s' 2: p a
KÖPER	"s' 2: p e r
KÖPT	"s' 2: p t
KÖPTE	"s' 2: p t e
KÖR	"k 2: r
KÖRA	"s' 2: r a
KÖRDE	"s' 2: d` e
KÖRT	"s' 2: t`
KÖTT	"s' 9 t
L	"E l
LA	"l A:
LAG	"l A: g
LAGA	"l A: g a
LAGAR	"l A: g a r
LAGEN	"l A: g e n
LAGET	"l A: g e t
LAGT	"l a k t
LAND	"l a n d
LANDET	"l a n d d e t
LARRY	"l a r Y
LE	"l e:
LEDA	"l e: d a
LEDARE	"l e: d a r e
LEDER	"l e: d e r
LEDSEN	"l E s e n
LEE	"l i:
LEK	"l e: k
LEKA	"l e: k a
LEKER	"l e: k e r
LEO	"l e: U
LETA	"l e: t a
LETADE	"l e: t a d e
LETAR	"l e: t a r
LETAT	"l e: t a t
LEVA	"l e: v a
LEVANDE	"l e: v a n d e
LEVDE	"l e: v d e
LEVER	"l e: v e r
LEX	"l E k s
LIGGA	"l I g a
LIGGER	"l I g e r
LIK	"l i: k
LIKA	"l i: k a
LIKNANDE	"l i: k n a n d e
LIKNAR	"l i: k n a r
LIKSOM	"l i: k %S O m
LILLA	"l I l a
LILLE	"l I l e
LISA	"l i: s a
LISTA	"l I s t a
LISTAN	"l I s t a n
LITA	"l i: t a
LITAR	"l i: t a r
LITE	"l i: t e
LITEN	"l i: t e n
LITET	"l i: t e t
LIV	"l i: v
LIVET	"l i: v e t
LJUD	"j }: d
LJUGA	"j }: g a
LJUGER	"j }: g e r
LJUS	"j }: s
LJUSET	"j }: s e t
LJÖG	"j 2: g
LONDON	"l O n d O n
LORD	"l o: d`
LOSS	"l O s
LOV	"l u: v
LOVA	"l o: v a
LOVADE	"l u: v a d e
LOVAR	"l o: v a r
LUFT	"l u0 f t
LUFTEN	"l u0 f t e n
LUGN	"l u0 N n
LUGNA	"l u0 N n a
LUGNT	"l u0 N n t
LUKTAR	"l u0 k t a r
LUNCH	"l u0 n` s`
LURA	"l }: r a
LURADE	"l }: r a d e
LUSTIGT	"l u0 s t I k t
LYCKA	"l Y k a
LYCKADES	"l Y k a d e s
LYCKAS	"l Y k a s
LYCKLIG	"l Y k l I g
LYCKLIGA	"l Y k l I g a
LYSSNA	"l Y s n a
LYSSNAR	"l Y s n a r
LÄGENHET	"l E: g e n %h e: t
LÄGET	"l E: g e t
LÄGG	"l E g
LÄGGA	"l E g a
LÄGGER	"l E g e r
LÄKARE	"l E: k a r e
LÄMNA	"l E m n a
LÄMNADE	"l E m n a d e
LÄMNAR	"l E m n a r
LÄMNAT	"l E m n a t
LÄNGE	"l E N e
LÄNGRE	"l E N r e
LÄR	"l E: r
LÄRA	"l E: r a
LÄRARE	"l E: r a r e
LÄRDE	"l E: d` e
LÄRT	"l E: t`
LÄS	"l E: s
LÄSA	"l E: s a
LÄSER	"l E: s e r
LÄST	"l E s t
LÄSTE	"l E: s t e
LÄT	"l E: t
LÄTT	"l E t
LÄTTARE	"l E t a r e
LÅG	"l o: g
LÅNA	"l o: n a
LÅNG	"l O N
LÅNGA	"l O N a
LÅNGT	"l O N t
LÅS	"l o: s
LÅT	"l o: t
LÅTA	"l o: t a
LÅTER	"l o: t e r
LÅTSAS	"l O t s a s
LÖGN	"l 9 N n
LÖGNAKTIG	"l 9 N n %a k t I g
LÖJLIGT	"l 9 j l I k t
LÖJTNANT	"l 9 j t n a n t
LÖRDAG	"l 2: d` A: g
LÖSA	"l 2: s a
LÖSER	"l 2: s e r
MAGEN	"m A: g e n
MAGI	m a "g i:
MAJESTÄT	m a j e "s t E: t
MAJOR	m a "j u: r
MAKE	"m E j k
MAKT	"m a k t
MAMMA	"m a m a
MAMMAS	"m a m a s
MAN	"m A: n
MANNEN	"m a n e n
MARIA	m a "r i: a
MARK	"m a r k
MARKEN	"m a r k e n
MARTIN	m a "t` i: n
MASSA	"m a s a
MASSOR	"m a s U r
MAT	"m A: t
MATCH	"m a t` s`
MATCHEN	"m a t` s` e n
MATEN	"m A: t e n
MATT	"m a t
MAX	"m a k s
MED	"m e: d
MEDAN	"m e: d a n
MEDDELANDE	"m e: %d e: l a n d d e
MEDICIN	m e d I "s i: n
MEJ	"m E j
MELLAN	"m E l a n
MEN	"m e: n
MENADE	"m e: n a d e
MENAR	"m e: n a r
MENING	"m e: n I N
MENINGEN	"m e: n I N e n
MER	"m e: r
MERA	"m e: r a
METER	"m e: t e r
MICHAEL	"m i: k a e l
MIDDAG	"m I d A: g
MIDDAGEN	"m I d A: g e n
MIG	"m E j
MIKE	"m a j k
MIL	"m i: l
MILJON	m I l "j u: n
MILJONER	m I l "j u: n e r
MIN	"m I n
MINA	"m i: n a
MINDRE	"m I n d r e
MINNAS	"m I n a s
MINNE	"m I n e
MINNEN	"m I n e n
MINNS	"m I n s
MINST	"m I n s t
MINSTA	"m I n s t a
MINUT	m I "n }: t
MINUTER	m I "n }: t e r
MISS	"m I s
MISSA	"m I s a
MISSADE	"m I s a d e
MISSAR	"m I s a r
MISSTAG	"m I %s t A: g
MISSTÄNKT	"m I %s t E N k t
MITT	"m I t
MOBIL	m U "b i: l
MOD	"m u: d
MONSTER	"m O n s t e r
MOR	"m u: r
MORD	"m u: d`
MORDET	"m u: d` e t
MORGAN	"m O r g a n
MORGON	"m O r g O n
MORGONEN	"m O r g O n e n
MORMOR	"m U r %m U r
MORSE	"m O s` e
MOT	"m u: t
MR	"m I s t e r
MRS	"m I s I s
MUN	"m u0 n
MUNNEN	"m u0 n e n
MUSIK	m }: "s i: k
MUSIKEN	m }: "s i: k e n
MYCKET	"m Y k e t
MÄN	"m E n
MÄNNEN	"m E n e n
MÄNNISKA	"m E n I S a
MÄNNISKOR	"m E n I S U r
MÄNNISKORNA	"m E n I S U n` a
MÄSTARE	"m E s t a r e
MÅ	"m o:
MÅL	"m o: l
MÅLET	"m o: l e t
MÅNAD	"m o: n a d
MÅNADER	"m o: n a d e r
MÅNGA	"m O N a
MÅR	"m o: r
MÅSTE	"m O s t e
MÖJLIGHET	"m 9 j l I g %h e: t
MÖJLIGT	"m 9 j l I k t
MÖRDA	"m 2: d` a
MÖRDADE	"m 2: d` a d e
MÖRDARE	"m 2: d` a r e
MÖRDAREN	"m 2: d` a r e n
MÖRKRET	"m 9 r k r e t
MÖRKT	"m 9 r k t
MÖTA	"m 2: t a
MÖTE	"m 2: t e
MÖTER	"m 2: t e r
MÖTET	"m 2: t e t
N	"E n
NAMN	"n a m n
NAMNET	"n a m n e t
NARRAKTIG	"n a r %a k t I g
NATT	"n a t
NATTEN	"n a t e n
NATURLIGTVIS	n a t }: r l` I k "t v i: s
NED	"n e: d
NEJ	"n E j
NER	"n e: r
NERE	"n e: r e
NERVÖS	n E r "v 2: s
NEW	"n j }:
NI	"n i:
NICK	"n I k
NIO	"n i: U
NOG	"n u: g
NOGA	"n u: g a
NORMAL	n U r "m A: l
NORMALT	n U r "m A: l t
NU	"n }:
NUMMER	"n u0 m e r
NUMRET	"n u0 m r e t
NY	"n y:
NYA	"n y: a
NYCKELN	"n Y k e l n
NYCKLARNA	"n Y k l a n` a
NYHETER	"n y: %h e: t e r
NYHETERNA	"n y: %h e: t e n` a
NYLIGEN	"n y: l I g e n
NYSS	"n Y s
NYTT	"n Y t
NYTTA	"n Y t a
NÄMNDE	"n E m n d e
NÄR	"n E: r
NÄRA	"n E: r a
NÄRHETEN	"n E: r %h e: t e n
NÄRMAR	"n E r m a r
NÄRMARE	"n E r m a r e
NÄSTA	"n E s t a
NÄSTAN	"n E s t a n
NÅ	"n o:
NÅD	"n o: d
NÅGON	"n o: g O n
NÅGONSIN	"n o: g O n s I n
NÅGONSTANS	"n o: g O n s t a n s
NÅGONTING	"n o: g O n %t I N
NÅGOT	"n o: g O t
NÅGRA	"n o: r a
NÅN	"n O n
NÅNSIN	"n O n s I n
NÅNSTANS	"n O n s t a n s
NÅNTING	"n O n t I N
NÅR	"n o: r
NÅT	"n o: t
NÅTT	"n O t
NÖJD	"n 9 j d
NÖJE	"n 9 j e
O	"u:
OAVSETT	"u: A: v %s E t
OCH	"O k
OCKSÅ	"O k s O
OF	"O v
OFFER	"O f e r
OFTA	"O f t a
OH	"u:
OJ	"O j
OK	"u: k
OKEJ	U "k E j
OLÄRAKTIG	"u: l E: r %a k t I g
OLIKA	"u: %l i: k a
OLIVER	U "l i: v e r
OLYCKA	"u: %l Y k a
OM	"O m
OMBORD	O m "b u: d`
OMEDELBART	"u: m e: d e l %b A: t`
OMKRING	O m "k r I N
OMRÅDE	"O m %r o: d e
OMRÅDET	"O m %r o: d e t
OMÖJLIGT	"u: %m 9 j l I k t
ONDA	"U n d a
ONT	"U n t
OPERATION	O p e r a "S u: n
ORD	"u: d`
ORDENTLIGT	O "d` E n t l I k t
ORDER	"o: d` e r
ORDET	"u: d` e t
ORDNA	"o: d` n` a
ORDNAR	"o: d` n` a r
ORDNING	"o: d` n` I N
ORKAR	"O r k a r
OROA	"u: %r u: a
OROAR	"u: %r u: a r
OROLIG	"u: %r u: l I g
ORSAK	"u: s` A: k
OSKYLDIG	"u: %S Y l d I g
OSS	"O s
OTROLIGT	"u: %t r u: l I g t
PA	"p a
PACKA	"p a k a
PAPPA	"p a p a
PAPPAS	"p a p a s
PAPPER	"p a p e r
PAR	"p A: r
PARIS	"p A: r I s
PARTNER	"p A: t` n` e r
PASS	"p a s
PASSA	"p a s a
PASSAR	"p a s a r
PAUL	"p o: l
PENGAR	"p E N a r
PENGARNA	"p E N a n` a
PER	"p E: r
PERFEKT	"p E: r %f E k t
PERSON	p e "s` u: n
PERSONEN	p e "s` u: n e n
PERSONER	p e "s` u: n e r
PERSONLIGT	p e "s` u: n l I k t
PETE	"p i: t
PETER	"p e: t e r
PHIL	"f I l
PISTOL	p I "s t u: l
PISTOLEN	p I "s t u: l e n
PLAN	"p l A: n
PLANEN	"p l A: n e n
PLANER	"p l A: n e r
PLANET	p l a "n e: t
PLANETEN	p l a "n e: t e n
PLATS	"p l a t s
PLATSEN	"p l a t s e n
PLATSER	"p l a t s e r
PLOCKA	"p l O k a
PLUS	"p l u0 s
PLÖTSLIGT	"p l 9 t s l I k t
POJKAR	"p O j k a r
POJKE	"p O j k e
POJKEN	"p O j k e n
POJKVÄN	"p O j k %v E n
POLIS	p U "l i: s
POLISEN	p U "l i: s e n
POLISER	p U "l i: s e r
POSITION	p U s I "S u: n
POÄNG	p U "E N
PRATA	"p r A: t a
PRATADE	"p r A: t a d e
PRATAR	"p r A: t a r
PRATAT	"p r A: t a t
PRECIS	p r e "s i: s
PRESENT	p r e "s E n t
PRESENTERA	p r e s e n "t e: r a
PRESIDENT	p r e s I "d E n t
PRESIDENTEN	p r e s I "d E n t e n
PRIS	"p r i: s
PRISET	"p r i: s e t
PRIVAT	p r I "v A: t
PROBLEM	p r U "b l e: m
PROBLEMET	p r U "b l e: m e t
PROCENT	p r U "s E n t
PROFESSOR	p r U "f E s U r
PROVA	"p r u: v a
PÅ	"p o:
PÅGÅR	"p o: %g o: r
PÅMINNER	"p o: %m I n e r
PÅSTÅR	"p o: %s t o: r
RACHEL	"r A: k e l
RAKT	"r A: k t
RAPPORT	r a "p O t`
RARING	"r A: r I N
RAY	"r E j
RED	"r e: d
REDA	"r e: d a
REDAN	"r e: d a n
REDO	"r e: d U
REGERINGEN	r e "j e: r I N e n
REGLER	"r e: g l e r
REGLERNA	"r e: g l e n` a
REN	"r e: n
RENA	"r e: n a
RENT	"r e: n t
RESA	"r e: s a
RESAN	"r e: s a n
RESER	"r e: s e r
RESPEKT	r e "s p E k t
RESTEN	"r E s t e n
RICHARD	"r I k a d`
RIK	"r i: k
RIKA	"r i: k a
RIKTIG	"r I k t I g
RIKTIGA	"r I k t I g a
RIKTIGT	"r I k t I k t
RING	"r I N
RINGA	"r I N a
RINGDE	"r I N d e
RINGEN	"r I N e n
RINGER	"r I N e r
RINGT	"r I N t
ROBERT	"r o: b e t`
ROBIN	"r O b I n
ROLIG	"r u: l I g
ROLIGT	"r u: l I k t
ROLL	"r O l
ROM	"r O m
ROSA	"r o: s a
ROSE	"r u: s
RUM	"r u0 m
RUMMET	"r u0 m e t
RUNT	"r u0 n t
RYAN	"r y: a n
RYGGEN	"r Y g e n
RÄCKER	"r E k e r
RÄDD	"r E d
RÄDDA	"r E d a
RÄDDADE	"r E d a d e
RÄDSLA	"r E: d s l a
RÄKNA	"r E: k n a
RÄKNAR	"r E: k n a r
RÄTT	"r E t
RÄTTA	"r E t a
RÄTTEN	"r E t e n
RÅD	"r o: d
RÅKAR	"r o: k a r
RÖD	"r 2: d
RÖDA	"r 2: d a
RÖKA	"r 2: k a
RÖR	"r 2: r
RÖRA	"r 2: r a
RÖST	"r 9 s t
S	"E s
SA	"s A:
SADE	"s A: d e
SAGT	"s a k t
SAK	"s A: k
SAKEN	"s A: k e n
SAKER	"s A: k e r
SAKERNA	"s A: k e n` a
SAKNA	"s A: k n a
SAKNAR	"s A: k n a r
SAKNAS	"s A: k n a s
SAKNAT	"s A: k n a t
SAKTA	"s a k t a
SAM	"s a m
SAMLA	"s a m l a
SAMMA	"s a m a
SAMMAN	"s a m a n
SAMTAL	"s a m %t A: l
SAMTALET	"s a m %t A: l e t
SAMTIDIGT	"s a m %t i: d I k t
SAN	"s a n
SANNING	"s a n I N
SANNINGEN	"s a n I N e n
SANT	"s a n t
SARA	"s A: r a
SARAH	"s A: r a
SATT	"s a t
SATTE	"s a t e
SCOTT	"s k O t
SE	"s e:
SEDAN	s e "d a n
SEKUND	s e "k u0 n d
SEKUNDER	s e "k u0 n d e r
SEMESTER	s e "m E s t e r
SEN	"s e: n
SENARE	"s e: n a r e
SENAST	"s e: n a s t
SENASTE	"s e: n a s t e
SENT	"s e: n t
SER	"s e: r
SERGEANT	s e r "S a n t
SES	"s e: s
SETT	"s E t
SEX	"s E k s
SHERIFF	S e "r I f
SHERIFFEN	S e "r I f e n
SIDA	"s i: d a
SIDAN	"s i: d a n
SIG	"s E j
SIMON	"s i: m O n
SIN	"s I n
SINA	"s i: n a
SIR	"s 2: r
SIST	"s I s t
SISTA	"s I s t a
SITT	"s I t
SITTA	"s I t a
SITTER	"s I t e r
SITUATION	s I t }: a "S u: n
SITUATIONEN	s I t }: a "S u: n e n
SJU	"S }:
SJUK	"S }: k
SJUKA	"S }: k a
SJUKHUS	"S }: k %h }: s
SJUKHUSET	"S }: k %h }: s e t
SJUNGA	"S u0 N a
SJUNGER	"S u0 N e r
SJÄL	"S E: l
SJÄLV	"S E l v
SJÄLVA	"S E l v a
SJÄLVKLART	"S E l v %k l A: t`
SJÄLVMORD	"S E l v %m u: d`
SKA	"s k A:
SKADA	"s k A: d a
SKADAD	"s k A: d a d
SKADADE	"s k A: d a d e
SKAFFA	"s k a f a
SKALL	"s k a l
SKALLEN	"s k a l e n
SKAPA	"s k A: p a
SKAPADE	"s k A: p a d e
SKAPAR	"s k A: p a r
SKE	"S e:
SKEPP	"S E p
SKEPPET	"S E p e t
SKER	"S e: r
SKICKA	"S I k a
SKICKADE	"S I k a d e
SKICKAR	"S I k a r
SKICKAT	"S I k a t
SKILLNAD	"S I l n a d
SKIT	"S i: t
SKITEN	"S i: t e n
SKITER	"S i: t e r
SKITSNACK	"S i: t %s n a k
SKITSTÖVEL	"S i: t %s t 9 v e l
SKJUT	"S }: t
SKJUTA	"S }: t a
SKJUTEN	"S }: t e n
SKJUTER	"S }: t e r
SKOGEN	"s k u: g e n
SKOJAR	"s k O j a r
SKOLA	"s k u: l a
SKOLAN	"s k u: l a n
SKOR	"s k u: r
SKOTT	"s k U t
SKRATTA	"s k r a t a
SKRATTAR	"s k r a t a r
SKREV	"s k r e: v
SKRIKER	"s k r i: k e r
SKRIV	"s k r i: v
SKRIVA	"s k r i: v a
SKRIVER	"s k r i: v e r
SKRIVIT	"s k r i: v I t
SKRÄMDE	"s k r E m d e
SKRÄMMER	"s k r E m e r
SKULD	"s k u0 l d
SKULL	"s k u0 l
SKULLE	"s k u0 l e
SKYDD	"S Y d
SKYDDA	"S Y d a
SKYDDAR	"S Y d a r
SKYLDIG	"S Y l d I g
SKYNDA	"S Y n d a
SKÄL	"S E: l
SKÄMT	"S E m t
SKÄMTAR	"S E m t a r
SKÄR	"S E: r
SKÅL	"s k o: l
SKÖNT	"S 2: n t
SKÖT	"S 2: t
SKÖTA	"S 2: t a
SKÖTER	"S 2: t e r
SLAG	"s l A: g
SLAGS	"s l A: g s
SLAPPNA	"s l a p n a
SLIPPA	"s l I p a
SLIPPER	"s l I p e r
SLOG	"s l u: g
SLUT	"s l }: t
SLUTA	"s l }: t a
SLUTADE	"s l }: t a d e
SLUTAR	"s l }: t a r
SLUTAT	"s l }: t a t
SLUTET	"s l }: t e t
SLÄPP	"s l E p
SLÄPPA	"s l E p a
SLÄPPER	"s l E p e r
SLÄPPTE	"s l E p t e
SLÅ	"s l o:
SLÅR	"s l o: r
SLÅSS	"s l O s
SMAKA	"s m A: k a
SMAKAR	"s m A: k a r
SMART	"s m A: t`
SNABB	"s n a b
SNABBA	"s n a b a
SNABBARE	"s n a b a r e
SNABBT	"s n a p t
SNACKA	"s n a k a
SNACKAR	"s n a k a r
SNART	"s n A: t`
SNYGG	"s n Y g
SNYGGT	"s n Y k t
SNÄLL	"s n E l
SNÄLLA	"s n E l a
SNÄLLT	"s n E l t
SOLDAT	s U l "d A: t
SOLDATER	s U l "d A: t e r
SOLEN	"s u: l e n
SON	"s o: n
SORTS	"s O t` s`
SOV	"s o: v
SOVA	"s o: v a
SOVER	"s o: v e r
SPARA	"s p A: r a
SPARKEN	"s p a r k e n
SPECIELL	s p e s I "E l
SPECIELLT	s p e s I "E l t
SPEL	"s p e: l
SPELA	"s p e: l a
SPELADE	"s p e: l a d e
SPELAR	"s p e: l a r
SPELET	"s p e: l e t
SPRANG	"s p r a N
SPRING	"s p r I N
SPRINGA	"s p r I N a
SPRINGER	"s p r I N e r
SPRÅK	"s p r o: k
SPÄNNANDE	"s p E n a n d e
SPÅR	"s p o: r
SPÅRA	"s p o: r a
STACK	"s t a k
STACKARS	"s t a k a s`
STAD	"s t A: d
STADEN	"s t A: d e n
STAL	"s t A: l
STAN	"s t A: n
STANNA	"s t a n a
STANNADE	"s t a n a d e
STANNAR	"s t a n a r
STARK	"s t a r k
STARKA	"s t a r k a
STARKARE	"s t a r k a r e
STARTA	"s t A: t` a
STATIONEN	s t a "S u: n e n
STEG	"s t e: g
STEN	"s t e: n
STICK	"s t I k
STICKA	"s t I k a
STICKER	"s t I k e r
STIG	"s t i: g
STIL	"s t i: l
STILL	"s t I l
STILLA	"s t I l a
STJÄLA	"S E: l a
STOD	"s t u: d
STOLT	"s t O l t
STOPP	"s t O p
STOPPA	"s t O p a
STOPPAR	"s t O p a r
STOR	"s t u: r
STORA	"s t u: r a
STORT	"s t u: %t`
STRANDEN	"s t r a n d e n
STRAX	"s t r a k s
STREET	"s t r i: t
STRID	"s t r i: d
STRUNTAR	"s t r u0 n t a r
STUND	"s t u0 n d
STYCKEN	"s t Y k e n
STYR	"s t y: r
STYRKA	"s t Y r k a
STÄDA	"s t E: d a
STÄLL	"s t E l
STÄLLA	"s t E l a
STÄLLDE	"s t E l d e
STÄLLE	"s t E l e
STÄLLER	"s t E l e r
STÄLLET	"s t E l e t
STÄMMER	"s t E m e r
STÄNG	"s t E N
STÄNGA	"s t E N a
STÄNGER	"s t E N e r
STÅ	"s t o:
STÅR	"s t o: r
STÖD	"s t 2: d
STÖR	"s t 2: r
STÖRRE	"s t 9 r e
STÖRSTA	"s t 9 s` t` a
SUGER	"s }: g e r
SVAG	"s v A: g
SVAR	"s v A: r
SVARA	"s v A: r a
SVARADE	"s v A: r a d e
SVARAR	"s v A: r a r
SVARET	"s v A: r e t
SVART	"s v a t`
SVARTA	"s v a t` a
SVIN	"s v i: n
SVÄR	"s v E: r
SVÅR	"s v o: r
SVÅRT	"s v o: t`
SYND	"s Y n d
SYNS	"s y: n s
SYSSLAR	"s Y s l a r
SYSTEM	s Y "s t e: m
SYSTEMET	s Y "s t e: m e t
SYSTER	"s Y s t e r
SÄG	"s E j
SÄGA	"s E j a
SÄGER	"s E j e r
SÄGS	"s E j s
SÄKER	"s E: k e r
SÄKERHET	"s E: k e r %h e: t
SÄKERT	"s E: k e t`
SÄKRA	"s E: k r a
SÄLJA	"s E l j a
SÄLJER	"s E l j e r
SÄLLSKAP	"s E l %s k A: p
SÄNG	"s E N
SÄNGEN	"s E N e n
SÄRSKILT	"s E: %s` I l t
SÄTT	"s E t
SÄTTA	"s E t a
SÄTTER	"s E t e r
SÄTTET	"s E t e t
SÅ	"s o:
SÅDAN	"s o: d a n
SÅDANA	"s o: d a n a
SÅDANT	"s o: d a n t
SÅDÄR	s o: "d E: r
SÅG	"s o: g
SÅLDE	"s O l d e
SÅN	"s o: n
SÅNA	"s O n a
SÅNT	"s O n t
SÖKA	"s 2: k a
SÖKER	"s 2: k e r
SÖKTE	"s 2: k t e
SÖNDER	"s 9 n d e r
SÖT	"s 2: t
SÖTNOS	"s 2: t %n u: s
T	"t e:
TA	"t A:
TACK	"t a k
TACKA	"t a k a
TACKAR	"t a k a r
TAG	"t A: g
TAGET	"t A: g e t
TAGIT	"t A: g I t
TAKET	"t A: k e t
TAL	"t A: l
TALA	"t A: l a
TALADE	"t A: l a d e
TALAR	"t A: l a r
TALAS	"t A: l a s
TALAT	"t A: l a t
TANKAR	"t a N k a r
TANKE	"t a N k e
TANKEN	"t a N k e n
TAPPADE	"t a p a d e
TAPPAT	"t a p a t
TAR	"t A: r
TAXI	"t a k s I
TE	"t e:
TEAM	"t i: m
TECKEN	"t E k e n
TED	"t E d
TELEFON	t e l e "f o: n
TELEFONEN	t e l e "f o: n e n
TESTA	"t E s t a
TEXT	"t E k s t
THE	"t e:
THOMAS	"t U m a s
TID	"t i: d
TIDEN	"t i: d e n
TIDIGARE	"t i: d I g a r e
TIDIGT	"t i: d I k t
TIDNINGEN	"t i: d n I N e n
TILL	"t I l
TILLBAKA	t I l "b A: k a
TILLBAKS	t I l "b A: k s
TILLFÄLLE	"t I l %f E l e
TILLHÖR	"t I l %h 2: r
TILLRÄCKLIGT	"t I l %r E k l I k t
TILLS	"t I l s
TILLSAMMANS	t I l "s a m a n s
TILLSTÅND	"t I l %s t O n d
TIMMAR	"t I m a r
TIMME	"t I m e
TIO	"t i: U
TITT	"t I t
TITTA	"t I t a
TITTADE	"t I t a d e
TITTAR	"t I t a r
TJA	"s' a
TJEJ	"s' E j
TJEJEN	"s' E j e n
TJEJER	"s' E j e r
TJEJERNA	"s' E j e n` a
TJENA	"s' e: n a
TJÄNA	"s' E: n a
TJÄNAR	"s' E: n a r
TJÄNST	"s' E n s t
TOALETTEN	t u: a "l E t e n
TOG	"t u: g
TOKIG	"t u: k I g
TOLV	"t O l v
TOM	"t o: m
TOMMY	"t O m Y
TONY	"t o: n Y
TOPPEN	"t O p e n
TRE	"t r e:
TREDJE	"t r e: d j e
TREVLIG	"t r e: v l I g
TREVLIGT	"t r e: v l I k t
TRO	"t r u:
TRODDE	"t r U d e
TROLIGEN	"t r u: l I g e n
TROR	"t r u: r
TROTS	"t r O t s
TRYCK	"t r Y k
TRÄD	"t r E: d
TRÄFFA	"t r E f a
TRÄFFADE	"t r E f a d e
TRÄFFADES	"t r E f a d e s
TRÄFFAR	"t r E f a r
TRÄFFAS	"t r E f a s
TRÄFFAT	"t r E f a t
TRÅKIGT	"t r o: k I k t
TRÖTT	"t r 9 t
TUFF	"t u0 f
TUR	"t }: r
TUSEN	"t }: s e n
TUSENTALS	"t }: s e n %t A: l s
TV	"t e: %v e:
TVINGA	"t v I N a
TVUNGEN	"t v u0 N e n
TVÄTTA	"t v E t a
TVÅ	"t v o:
TYCKA	"t Y k a
TYCKER	"t Y k e r
TYCKS	"t Y k s
TYCKTE	"t Y k t e
TYDLIGEN	"t y: d l I g e n
TYP	"t y: p
TYST	"t Y s t
TYSTA	"t Y s t a
TYVÄRR	t Y "v E r
TÄNDER	"t E n d e r
TÄNK	"t E N k
TÄNKA	"t E N k a
TÄNKER	"t E N k e r
TÄNKT	"t E N k t
TÄNKTE	"t E N k t e
TÅGET	"t o: g e t
UMGÅS	"u0 m %g o: s
UNDAN	"u0 n d a n
UNDER	"u0 n d e r
UNDERBAR	"u0 n d e r %b A: r
UNDERBART	"u0 n d e r %b A: t`
UNDRADE	"u0 n d r a d e
UNDRAR	"u0 n d r a r
UNDVIKA	"u0 n d %v i: k a
UNG	"u0 N
UNGA	"u0 N a
UNGAR	"u0 N a r
UNGARNA	"u0 N a n` a
UNGE	"u0 N e
UNGEFÄR	u0 n j e "f E: r
UPP	"u0 p
UPPDRAG	"u0 p %d r A: g
UPPDRAGET	"u0 p %d r A: g e t
UPPE	"u0 p e
UPPFATTAT	"u0 p %f a t a t
UPPMÄRKSAMHET	"u0 p m E r k s a m %h e: t
UPPRÖRD	"u0 p %r 2: d`
UPPSKATTAR	"u0 p %s k a t a r
UPPTAGEN	"u0 p %t A: g e n
UR	"}: r
URSÄKT	"}: %s` E k t
URSÄKTA	"}: %s` E k t a
UT	"}: t
UTAN	"}: t a n
UTANFÖR	"}: t a n f 9 r
UTE	"}: t e
UTMÄRKT	"}: t %m E r k t
UTOM	"}: t O m
VA	"v a
VACKER	"v a k e r
VACKERT	"v a k e t`
VACKRA	"v a k r a
VAD	"v a d
VADÅ	v a "d o:
VAKEN	"v A: k e n
VAKNA	"v A: k n a
VAKNADE	"v A: k n a d e
VAKNAR	"v A: k n a r
VAL	"v A: l
VALDE	"v A: l d e
VAN	"v A: n
VANLIG	"v A: n l I g
VANLIGA	"v A: n l I g a
VANLIGT	"v A: n l I k t
VANN	"v a n
VAPEN	"v A: p e n
VAPNEN	"v A: p n e n
VAPNET	"v A: p n e t
VAR	"v A: r
VARA	"v A: r a
VARANDRA	v a "r a n d r a
VARANN	v a "r a n
VARE	"v A: r e
VARENDA	v a "r E n d a
VARFÖR	"v a r f 9 r
VARIT	"v A: r I t
VARJE	v A: r "j E 
VARKEN	"v a r k e n
VARM	"v a r m
VARMT	"v a r m t
VARSÅGOD	v A: s` o: "g u: d
VART	"v a t`
VATTEN	"v a t e n
VATTNET	"v a t n e t
VECKA	"v E k a
VECKAN	"v E k a n
VECKOR	"v E k U r
VELAT	"v e: l a t
VEM	"v E m
VEMS	"v E m s
VERKADE	"v E r k a d e
VERKAR	"v E r k a r
VERKLIGEN	"v E r k l I g e n
VET	"v e: t
VETA	"v e: t a
VETAT	"v e: t a t
VI	"v i:
VIA	"v i: a
VID	"v i: d
VIDARE	"v i: d a r e
VIKTIG	"v I k t I g
VIKTIGA	"v I k t I g a
VIKTIGASTE	"v I k t I g a s t e
VIKTIGT	"v I k t I k t
VILA	"v i: l a
VILJA	"v I l j a
VILKA	"v I l k a
VILKEN	"v I l k e n
VILKET	"v I l k e t
VILL	"v I l
VILLE	"v I l e
VILSE	"v I l s e
VIN	"v i: n
VINDEN	"v I n d e n
VINNA	"v I n a
VINNER	"v I n e r
VIS	"v i: s
VISA	"v i: s a
VISADE	"v i: s a d e
VISAR	"v i: s a r
VISSA	"v I s a
VISST	"v I s t
VISSTE	"v I s t e
VIT	"v i: t
VITA	"v i: t a
VORE	"v u: r e
VÄG	"v E: g
VÄGEN	"v E: g e n
VÄGGEN	"v E g e n
VÄGRAR	"v E: g r a r
VÄL	"v E: l
VÄLDIGT	"v E l d I k t
VÄLJA	"v E l j a
VÄLJER	"v E l j e r
VÄLKOMMEN	"v E: l %k O m e n
VÄLKOMNA	"v E: l %k O m n a
VÄN	"v E n
VÄND	"v E n d
VÄNDA	"v E n d a
VÄNDER	"v E n d e r
VÄNNER	"v E n e r
VÄNSTER	"v E n s t e r
VÄNTA	"v E n t a
VÄNTADE	"v E n t a d e
VÄNTAR	"v E n t a r
VÄNTAT	"v E n t a t
VÄRD	"v E: d`
VÄRLD	"v E: d`
VÄRLDEN	"v E: d` e n
VÄRLDENS	"v E: d` e n s
VÄRRE	"v E r e
VÄRSTA	"v E s` t` a
VÄRT	"v E: t`
VÄSKA	"v E s k a
VÄSKAN	"v E s k a n
VÄXER	"v E k s e r
VÄXTE	"v E k s t e
VÅGAR	"v o: g a r
VÅLD	"v O l d
VÅR	"v o: r
VÅRA	"v o: r a
VÅRAN	"v o: r a n
VÅRT	"v o: t`
WALTER	"v a l t e r
WASHINGTON	"v O s` I N t O n
WILL	"v I l
YORK	"j o: k
ÄGER	"E: g e r
ÄGG	"E g
ÄKTA	"E k t a
ÄKTENSKAP	"E k t e n %s k A: p
ÄLDRE	"E l d r e
ÄLSKA	"E l s k a
ÄLSKADE	"E l s k a d e
ÄLSKAR	"E l s k a r
ÄLSKLING	"E l s k l I N
ÄN	E n
ÄNDA	"E n d a
ÄNDRA	"E n d r a
ÄNDRAR	"E n d r a r
ÄNDÅ	E n "d o:
ÄNNU	"E n }:
ÄNTLIGEN	"E n t l I g e n
ÄR	"E: r
ÄRA	"E: r a
ÄRLIG	"E: l` I g
ÄRLIGT	"E: l` I k t
ÄT	"E: t
ÄTA	"E: t a
ÄTER	"E: t e r
ÄTIT	"E: t I t
ÄVEN	"E: v e n
Å	"o:
ÅH	"o:
ÅK	"o: k
ÅKA	"o: k a
ÅKER	"o: k e r
ÅKT	"o: k t
ÅKTE	"o: k t e
ÅLDER	"O l d e r
ÅR	"o: r
ÅREN	"o: r e n
ÅRET	"o: r e t
ÅRS	"o: s`
ÅT	"o: t
ÅTERVÄNDA	"o: t e r %v E n d a
ÅTERVÄNDER	"o: t e r %v E n d e r
ÅTMINSTONE	o: t "m I n s t O n e
ÅTTA	"O t a
ÖDE	"2: d e
ÖGA	"2: g a
ÖGON	"2: g O n
ÖGONBLICK	"2: g O n %b l I k
ÖGONEN	"2: g O n e n
ÖL	"2: l
ÖN	"2: n
ÖNSKAR	"9 n s k a r
ÖPPEN	"9 p e n
ÖPPET	"9 p e t
ÖPPNA	"9 p n a
ÖPPNAR	"9 p n a r
ÖVER	"2: v e r
ÖVERALLT	2: v e r "a l t
ÖVERENS	2: v e "r E n s
ÖVERLEVA	"2: v e %l` e: v a
ÖVERLEVER	"2: v e %l` e: v e r
ÖVERRASKNING	"2: v e %r a s k n I N
ÖVERSATT	"2: v e %s` a t
ÖVERSTE	"2: v e s` t` e
